30
t1 t1 t1 t1 t1 t1 t1 t1 t1 t1 t1 t1 t1 t1 t1 t1 t1 t1 t1 t1 t1 t1 t1 t1 t1 t1 t1 t1 t1 t1
t1 t1 t1 t1 t1 t1 t1 t1 t1 t1 t1 t1 t1 t1 t1 t1 t1 t1 t1 t1 t1 t1 t1 t1 t1 t1 t1 t1 t1 t1
t1 t1 t1 t1 t1 t1 t1 t1 t1 t1 t1 t1 t1 t1 t1 t1 t1 t1 t1 t1 t1 t1 t1 t1 t1 t1 t1 t1 t1 t1
t1 t1 t1 t1 t1 t1 t1 t1 t1 t1 t1 t1 t1 t1 t1 t1 t1 t1 t1 t1 t1 t1 t1 t1 t1 t1 t1 t1 t1 t1
t1 t1 t1 t1 t1 t1 t1 t1 t1 t1 t1 t1 t1 t1 t1 t1 t1 t1 t1 t1 t1 t1 t1 t1 t1 t1 t1 t1 t1 t1
t1 t1 t1 t1 t1 t1 t1 t1 t1 t1 t1 t1 t1 t1 t1 t1 t1 t1 t1 t1 t1 t1 t1 t1 t1 t1 t1 t1 t1 t1
t1 t1 t1 t1 t1 t1 t1 t1 t1 t1 t1 t1 t1 t1 t1 t1 t1 t1 t1 t1 t1 t1 t1 t1 t1 t1 t1 t1 t1 t1
t1 t1 t1 t1 t1 t1 t1 t1 t1 t1 t1 t1 t1 t1 t1 t1 t1 t1 t1 t1 t1 t1 t1 t1 t1 t1 t1 t1 t1 t1
t1 t1 t1 t1 t1 t1 t1 t1 t1 t1 t1 t1 t1 t1 t1 t1 t1 t1 t1 t1 t1 t1 t1 t1 t1 t1 t1 t1 t1 t1
t1 t1 t1 t1 t1 t1 t1 t1 t1 t1 t1 t1 t1 t1 t1 t1 t1 t1 t1 t1 t1 t1 t1 t1 t1 t1 t1 t1 t1 t1
t1 t1 t1 t1 t1 t1 t1 t1 t1 t1 t1 t1 t1 t1 t1 t1 t1 t1 t1 t1 t1 t1 t1 t1 t1 t1 t1 t1 t1 t1
t1 t1 t1 t1 t1 t1 t1 t1 t1 t1 t1 t1 t1 t1 t1 t1 t1 t1 t1 t1 t1 t1 t1 t1 t1 t1 t1 t1 t1 t1
t1 t1 t1 t1 t1 t1 t1 t1 t1 t1 t1 t1 t1 t1 t1 t1 t1 t1 t1 t1 t1 t1 t1 t1 t1 t1 t1 t1 t1 t1
t1 t1 t1 t1 t1 t1 t1 t1 t1 t1 t1 t1 t1 t1 t1 t1 t1 t1 t1 t1 t1 t1 t1 t1 t1 t1 t1 t1 t1 t1
t1 t1 t1 t1 t1 t1 t1 t1 t1 t1 t1 t1 t1 t1 t1 t1 t1 t1 t1 t1 t1 t1 t1 t1 t1 t1 t1 t1 t1 t1
t1 t1 t1 t1 t1 t1 t1 t1 t1 t1 t1 t1 t1 t1 t1 t1 t1 t1 t1 t1 t1 t1 t1 t1 t1 t1 t1 t1 t1 t1
t1 t1 t1 t1 t1 t1 t1 t1 t1 t1 t1 t1 t1 t1 t1 t1 t1 t1 t1 t1 t1 t1 t1 t1 t1 t1 t1 t1 t1 t1
t1 t1 t1 t1 t1 t1 t1 t1 t1 t1 t1 t1 t1 t1 t1 t1 t1 t1 t1 t1 t1 t1 t1 t1 t1 t1 t1 t1 t1 t1
t1 t1 t1 t1 t1 t1 t1 t1 t1 t1 t1 t1 t1 t1 t1 t1 t1 t1 t1 t1 t1 t1 t1 t1 t1 t1 t1 t1 t1 t1
t1 t1 t1 t1 t1 t1 t1 t1 t1 t1 t1 t1 t1 t1 t1 t1 t1 t1 t1 t1 t1 t1 t1 t1 t1 t1 t1 t1 t1 t1
t1 t1 t1 t1 t1 t1 t1 t1 t1 t1 t1 t1 t1 t1 t1 t1 t1 t1 t1 t1 t1 t1 t1 t1 t1 t1 t1 t1 t1 t1
t1 t1 t1 t1 t1 t1 t1 t1 t1 t1 t1 t1 t1 t1 t1 t1 t1 t1 t1 t1 t1 t1 t1 t1 t1 t1 t1 t1 t1 t1
t1 t1 t1 t1 t1 t1 t1 t1 t1 t1 t1 t1 t1 t1 t1 t1 t1 t1 t1 t1 t1 t1 t1 t1 t1 t1 t1 t1 t1 t1
t1 t1 t1 t1 t1 t1 t1 t1 t1 t1 t1 t1 t1 t1 t1 t1 t1 t1 t1 t1 t1 t1 t1 t1 t1 t1 t1 t1 t1 t1
t1 t1 t1 t1 t1 t1 t1 t1 t1 t1 t1 t1 t1 t1 t1 t1 t1 t1 t1 t1 t1 t1 t1 t1 t1 t1 t1 t1 t1 t1
t1 t1 t1 t1 t1 t1 t1 t1 c1 t1 t1 t1 t1 t1 t1 t1 t1 t1 t1 t1 t1 t1 t1 t1 t1 t1 t1 t1 t1 t1
t1 t1 t1 t1 t1 b1 t1 t1 t1 t1 t1 t1 t1 t1 t1 t1 t1 t1 t1 t1 t1 t1 t1 t1 t1 t1 t1 t1 t1 t1
t1 t1 t1 t1 t1 w1 t1 t1 d1 t1 t1 t1 t1 t1 t1 t1 t1 t1 t1 t1 t1 t1 t1 t1 t1 t1 t1 t1 t1 t1
q1 q2 t1 w1 w1 w2 w1 t1 w1 t1 t1 t1 t1 t1 t1 t1 t1 t1 t1 t1 t1 t1 t1 t1 t1 t1 t1 t1 t1 t1
w1 w1 w1 w2 w2 w2 w2 w1 t1 t1 t1 t1 t1 t1 t1 t1 t1 t1 t1 t1 t1 t1 t1 t1 t1 t1 t1 t1 t1 t1
default
2 5 4 4
with
