6
w1 w1 w1 w1 w1 w1 w1 w1 w1 w1 w1 w1 w1 w1 w1 w1 w1 w1 w1 w1 w1 w1 w1 w1 w1 w1 w1 w1 w1 w1
w2 t1 t1 t1 t1 t1 t1 t1 t1 t1 t1 t1 t1 t1 t1 t1 t1 t1 t1 t1 t1 t1 t1 t1 t1 t1 t1 t1 t1 w2
w2 t1 t1 t1 t1 t1 t1 t1 t1 t1 t1 t1 t1 t1 t1 t1 t1 t1 t1 t1 t1 t1 t1 t1 t1 t1 t1 t1 t1 w2
w2 t1 t1 c1 c1 t1 c1 c1 t1 c1 c1 t1 c1 c1 t1 t1 c1 c1 t1 c1 c1 t1 c1 c1 t1 c1 c1 t1 c1 w2
w2 q2 t1 t1 t1 t1 t1 t1 t1 t1 t1 t1 t1 t1 t1 t1 t1 t1 t1 t1 t1 t1 t1 t1 t1 t1 t1 t1 q1 w2
w2 w1 w1 t1 t1 w1 t1 t1 w1 t1 t1 w1 t1 t1 w1 w1 t1 t1 w1 t1 t1 w1 t1 t1 w1 t1 t1 w1 w1 w2
default
2 2 28 2
with